70
0000000000000000000000000000000000000000000000000000000000000000000000
0000000000000000000000000000000000000000000000000000000000000000000000
0000000000000000000000000000000000000000000000000000000000000000000000
0000000000000000000000000000000000000000000000000000000000000000000000
0000000000000000000000000000000000000000000000000000000000000000000000
0000000000000000000000000000000000000000000000000000000000000000000000
0000000000000000000000000000000000000000000000000000000000000000000000
0000000000000000000023030000000000000000000000000000000000000000000000
0000000000000000002313330300000000000000000000000000000000000000000000
0000050000020000231300003303000000050000050000050000050000050000050000
0101010101010101010101010101010101010101010101010101010101010101010101